NO      ./N.xpm   
SO      ./S.xpm         
WE      ./W.xpm          
EA      ./E.xpm

F 220,100,0
C 225,30,0


11111111111

11111111111
11111111111
11111111111
11111111111
10000000001
10000000001
10000N00001
10000000001
10000000001
11111111111
11111111111






