NO ./textures/N.xpm
SO ./textures/S.xpm
EA ./textures/E.xpm
WE ./textures/W.xpm

F 18,53,25
C 153,204,255

111111111111
1         11
1       0001
1000000 0011
10W000000001
111111111111
11         1
111111111111
