NO ./textures/N.xpm
SO ./textures/S.xpm
WE ./textures/W.xpm
EA ./textures/E.xpm

F 111,111,111
C 155,100,160

 11111111
1000000001
1000000001
1000000001
10000N0001
1000000001
1000000001
1000000001
1000000001
 11111111