NO                 ./textures/no.xpm
SO ./textures/so.xpm
WE  	./textures/ea.xpm
EA 								./textures/we.xpm

C 155,100,				160
F   111,     111,111

1111    11
1001   1001
1111    11
 11111111
1000000001
1000000001
 11100111
10000N0001
 11111111
1000000001
1000000001
1111111111
    1111111111
    1000000001
     11111111