==586346== Memcheck, a memory error detector
==586346== Copyright (C) 2002-2017, and GNU GPL'd, by Julian Seward et al.
==586346== Using Valgrind-3.18.1 and LibVEX; rerun with -h for copyright info
==586346== Command: ./cub3d maps/good/cheese_maze.cub
==586346== 
=== WHOLE FILE ===
NO ./textures/N.xpm
SO ./textures/S.xpm
EA ./textures/E.xpm
WE ./textures/W.xpm
F 164,169,20
C 153,204,255
111111111111111111111
101000001000000000001
101010101011111110001
100010100010000010001
111110101111101011101
100000101000101000001
101111101011101111111
101000001010100000101
101011111010111110101
101010001010100010101
101110101010101010101
100000101010001010001
111111101011111011101
100000101000100010001
101110101110101110111
101000100000100010101
101011111111111010101
100010000000000010001
101010111011111111101
1N1000001000000000001
111111111111111111111


=== ORIENTATION ===
NORTH == textures/N.xpm
SOUTH == textures/S.xpm
WEST == textures/W.xpm
EAST == textures/E.xpm
=== FLOOR && CEILING ===
F = 164,169,20
C = 153,204,255
=== GAME MAP ===
'111111111111111111111'
'101000001000000000001'
'101010101011111110001'
'100010100010000010001'
'111110101111101011101'
'100000101000101000001'
'101111101011101111111'
'101000001010100000101'
'101011111010111110101'
'101010001010100010101'
'101110101010101010101'
'100000101010001010001'
'111111101011111011101'
'100000101000100010001'
'101110101110101110111'
'101000100000100010101'
'101011111111111010101'
'100010000000000010001'
'101010111011111111101'
'1N1000001000000000001'
'111111111111111111111'
=== NEW MAP ===
'111111111111111111111'
'1X1XXXXX1XXXXXXXXXXX1'
'1X1X1X1X1X1111111XXX1'
'1XXX1X1XXX1XXXXX1XXX1'
'11111X1X11111X1X111X1'
'1XXXXX1X1XXX1X1XXXXX1'
'1X11111X1X111X1111111'
'1X1XXXXX1X1X1XXXXX1X1'
'1X1X11111X1X11111X1X1'
'1X1X1XXX1X1X1XXX1X1X1'
'1X111X1X1X1X1X1X1X1X1'
'1XXXXX1X1X1XXX1X1XXX1'
'1111111X1X11111X111X1'
'1XXXXX1X1XXX1XXX1XXX1'
'1X111X1X111X1X111X111'
'1X1XXX1XXXXX1XXX1X1X1'
'1X1X11111111111X1X1X1'
'1XXX1XXXXXXXXXXX1XXX1'
'1X1X1X111X111111111X1'
'1X1XXXXX1XXXXXXXXXXX1'
'111111111111111111111'
==586346== 
==586346== FILE DESCRIPTORS: 4 open (3 std) at exit.
==586346== Open file descriptor 103: /usr/share/code/v8_context_snapshot.bin
==586346==    <inherited from parent>
==586346== 
==586346== 
==586346== HEAP SUMMARY:
==586346==     in use at exit: 0 bytes in 0 blocks
==586346==   total heap usage: 2,067 allocs, 2,067 frees, 1,481,768 bytes allocated
==586346== 
==586346== All heap blocks were freed -- no leaks are possible
==586346== 
==586346== For lists of detected and suppressed errors, rerun with: -s
==586346== ERROR SUMMARY: 0 errors from 0 contexts (suppressed: 2 from 1)
