==586562== Memcheck, a memory error detector
==586562== Copyright (C) 2002-2017, and GNU GPL'd, by Julian Seward et al.
==586562== Using Valgrind-3.18.1 and LibVEX; rerun with -h for copyright info
==586562== Command: ./cub3d maps/good/square_map.cub
==586562== 
=== WHOLE FILE ===
WE                            ./textures/W.xpm
NO      ./textures/N.xpm
SO ./textures/S.xpm
F   69,222,199
EA ./textures/E.xpm
C 235,198,52
111111111111111111111111
100000000000000000000001
100000000000000000000001
100000000N00000000000001
100000000000000000000001
100000000000000000000001
100000000000000000000001
100000111110000101010001
100000100010000000000001
100000100010000100010001
100000100010000000000001
100000111100001010100001
100000000000000000000001
100000000000000000000001
100000000000000000000001
100000000000000000000001
100000000000000000000001
100000000000000000000001
100000000000000000000001
111111111000000000000001
100100001000000000000001
100000101000000000000001
100100001000000000000001
100111111000000000000001
100000000000000000000001
100000000000000000000001
111111111111111111111111

=== ORIENTATION ===
NORTH == textures/N.xpm
SOUTH == textures/S.xpm
WEST == textures/W.xpm
EAST == textures/E.xpm
=== FLOOR && CEILING ===
F = 69,222,199
C = 235,198,52
=== GAME MAP ===
'111111111111111111111111'
'100000000000000000000001'
'100000000000000000000001'
'100000000N00000000000001'
'100000000000000000000001'
'100000000000000000000001'
'100000000000000000000001'
'100000111110000101010001'
'100000100010000000000001'
'100000100010000100010001'
'100000100010000000000001'
'100000111100001010100001'
'100000000000000000000001'
'100000000000000000000001'
'100000000000000000000001'
'100000000000000000000001'
'100000000000000000000001'
'100000000000000000000001'
'100000000000000000000001'
'111111111000000000000001'
'100100001000000000000001'
'100000101000000000000001'
'100100001000000000000001'
'100111111000000000000001'
'100000000000000000000001'
'100000000000000000000001'
'111111111111111111111111'
=== NEW MAP ===
'111111111111111111111111'
'1XXXXXXXXXXXXXXXXXXXXXX1'
'1XXXXXXXXXXXXXXXXXXXXXX1'
'1XXXXXXXXXXXXXXXXXXXXXX1'
'1XXXXXXXXXXXXXXXXXXXXXX1'
'1XXXXXXXXXXXXXXXXXXXXXX1'
'1XXXXXXXXXXXXXXXXXXXXXX1'
'1XXXXX11111XXXX1X1X1XXX1'
'1XXXXX10001XXXXXXXXXXXX1'
'1XXXXX10001XXXX1XXX1XXX1'
'1XXXXX10001XXXXXXXXXXXX1'
'1XXXXX1111XXXX1X1X1XXXX1'
'1XXXXXXXXXXXXXXXXXXXXXX1'
'1XXXXXXXXXXXXXXXXXXXXXX1'
'1XXXXXXXXXXXXXXXXXXXXXX1'
'1XXXXXXXXXXXXXXXXXXXXXX1'
'1XXXXXXXXXXXXXXXXXXXXXX1'
'1XXXXXXXXXXXXXXXXXXXXXX1'
'1XXXXXXXXXXXXXXXXXXXXXX1'
'111111111XXXXXXXXXXXXXX1'
'1XX1XXXX1XXXXXXXXXXXXXX1'
'1XXXXX1X1XXXXXXXXXXXXXX1'
'1XX1XXXX1XXXXXXXXXXXXXX1'
'1XX111111XXXXXXXXXXXXXX1'
'1XXXXXXXXXXXXXXXXXXXXXX1'
'1XXXXXXXXXXXXXXXXXXXXXX1'
'111111111111111111111111'
==586562== 
==586562== FILE DESCRIPTORS: 4 open (3 std) at exit.
==586562== Open file descriptor 103: /usr/share/code/v8_context_snapshot.bin
==586562==    <inherited from parent>
==586562== 
==586562== 
==586562== HEAP SUMMARY:
==586562==     in use at exit: 0 bytes in 0 blocks
==586562==   total heap usage: 2,316 allocs, 2,316 frees, 1,486,603 bytes allocated
==586562== 
==586562== All heap blocks were freed -- no leaks are possible
==586562== 
==586562== For lists of detected and suppressed errors, rerun with: -s
==586562== ERROR SUMMARY: 0 errors from 0 contexts (suppressed: 2 from 1)
