NO ./textures/N.xpm
SO ./textures/S.xpm
EA ./textures/E.xpm
WE ./textures/W.xpm
C 150,0,50
F 0,0,0

	1111111111111111111111111
	1000000000110000000000001
	10110000011100000000010001
	1001000000000000000000001
111111111011000011100000000111111
100000000011000001110111111000011
111101111111110111000000100011111
11110111111111011101010010001
11000000110101011100000000001111
10000000000000N00100000010000001111111111111111111111111111111
10000000000000000100000010000000000000000000000100000010000001
11000001110101011111011110011100000111111110000010000000011111
10000000000000000100000010000000000000000000000100000010000001
11000001110101011111011110011100000111111110000010000000011111
10000000000000000000000010000000000000000000000000000010000001
10000000000000000100000000000000000000000000000100000000000001
11000001110101011111011110011100000111111110000010000000011111
10000000000000000000000000000000000000000000000100000010000001
11000001110101011111011110011100000111111110000010000000011111
11000001110101011111011110011100000111111110000010000000011111
10000000000000000100000000000000000000000000000100000010000001
11000001110101011111011110011100000111111110000010000000011111
10000000000000000000000000000000000000000000000100000010000001
11000001110101011111011110011100000111111110000010000000011111
10000000000000000000000000000000000000000000000100000010000001
11000001110101011111011110011100000111111110000010000000011111
10000000000000000000000000000001111111111111111111111111111111
100000000000000011010100100011111
110000011101010111110111100111
11110111 1110101 101111010001
11111111 1111111 111111111111