NO ./textures/N.xpm
SO ./textures/S.xpm
EA ./textures/E.xpm
WE ./textures/W.xpm

C 100,100,100
F 50,50,50

	1111111111111111111111111
	1000000000110000000000001
	10110000011100000000010001
	1001000000000000000000001
111111111011000011100000000111111
100000000011000001110111111000011
111101111111110111000000100011111
11110111111111011101010010001
1100000011010101110000000000111
10000000000000N00100000010000001
10000000000000001101010010001111
110000011101010111110111100111
11110111 1110101 101111010001
11111111 1111111 111111111111