NO	./textures/N.xpm
SO	./textures/S.xpm
EA	./textures/E.xpm
WE	./textures/W.xpm


F 225,30,50
C 220,100,50

111111111111111111111
100000000000000000001
1000000000000N0000001
100000000000000000001
111111111111111111111