NO ./txt_n.xpm
SO ./txt_s.xpm
EA ./txt_e.xpm
WE ./txt_w.xpm

C 225,30,50
F 220,100,50

1111111111111111111111111
1000000000000000000000001
1000000000000000000000001
1000110000000000001100001
1000110000000000001100001
1000000000000000000000001
1000000000000000000000001
1000E00000000000000000001
1000000000000000000000001
1000000000000000000000001
1000000000000000000000001
1111111111111111111111111