NO	./txt_n.xpm
SO	./txt_s.xpm
EA	./txt_e.xpm
WE	./txt_w.xpm


F 225,30,50
C 220,100,50

111111111111111111111
100000000000000000001
100000000000000000001
100000000000000011111
111111100000000000001
100000000000000000001
100000000000000000001
100000000000001100001
111111111111111111111