NO ./txt_n.xpm
SO ./txt_s.xpm
EA ./txt_e.xpm
WE ./txt_w.xpm

C 225,30,50
F 220,100,50

	1111111111111111111111111
	1000000000110000000000001   
	1011000001110000000000001
	1001000000000000000000001
111111111011000011100000000111111
100000000011000001110111111000011
111101111111110111000000100011111
11110111111111011101010010001
11000000110101011100000010001
1000000W000000001100000010001
10000000000000001101010010001
110000011101010111110111100111
11110111 1110101 101111010001
11111111 1111111 111111111111