NO ./txt_n.xpm
SO ./txt_s.xpm
WE ./txt_w.xpm
EA ./txt_e.xpm

F 220,100,50
C 225,30,50

	1111111111111111111111111
	10000000001100000000      1
	1011000001110000000000001
	1001000000000000000000001
111111111011000001110000000011111
10000000001100000111011111100001
111101111111110111000000100011111
11110111111111011101010010001
11000000110101011100000010001
10000000000000001100000010001
10000000000000001101010010001
11000001110101011111011110N0111
11110111 1110101 101111010001
11111111 1111111 111111111111
