NO      N.xpm
WE      ./W.xpm
SO    ./S.xpm
C 250,      30,,,    0
F    220   ,100,    0
EA           ./E.xpm
	1111111111111111111111111
	1000000000110000000000001
	10110000011100000000010001
	1001000000000000000000001
111111111011000011100000000111111
100000000011000001110111111000011
111101111111110111000000100011111
11110111111111011101010010001
11000000110101011100000000001111
10000000000000N00100000010000001
10000000000000001101010010001111
110000011101010111110111100111
111101111110101 101111010001
11111111 1111111 111111111111