
       WE         ./W.xpm     

    SO 			   ./S.xpm     


      NO            ./N.xpm   

EA           ./E.xpm   


   C    ,255,      30,    0


   F    220   ,100,   0,


111111111111
100000000001
100000000001
100000000001
100000W000111
1000000000011
1111111111111
