
WE          ./W.xpm

SO 			   ./S.xpm


NO      N.xpm

EA           ./E.xpm


C 255,      30,,,    0
F    220   ,100,    0,


111111111111
100000000001
100000000011
100000000001N1
1111111111111
