NO      N.xpm
WE      ./W.xpm
SO    ./S.xpm
EA           ./E.xpm


F    220   ,100,    0
C 255,      30,,,    0


	1111111111111111111111111
	1000000000110000000000001
	10110000011100000000010001
	1001000000000000000000001
111111111011000011100000000111111
100000000011000001110111111000011
111101111111110111000000100011111
11110111111111011101010010001
110000001101010111000N0000001111
100000000000000100000010000001
10000000000000001101010010001111
110000011101010111110111100111
1111011111101011 101111010001
11111111 1111111 111111111111