==587075== Memcheck, a memory error detector
==587075== Copyright (C) 2002-2017, and GNU GPL'd, by Julian Seward et al.
==587075== Using Valgrind-3.18.1 and LibVEX; rerun with -h for copyright info
==587075== Command: ./cub3d maps/old/big_map.cub
==587075== 
=== WHOLE FILE ===
NO ./textures/N.xpm
SO ./textures/S.xpm
EA ./textures/E.xpm
WE ./textures/W.xpm
C 150,0,50
F 0,0,0
	1111111111111111111111111
	1000000000110000000000001
	10110000011100000000010001
	1001000000000000000000001
111111111011000011100000000111111
100000000011000001110111111000011
111101111111110111000000100011111
11110111111111011101010010001
11000000110101011100000000001111
10000000000000N00100000010000001111111111111111111111111111111
10000000000000000100000010000000000000000000000100000010000001
11000001110101011111011110011100000111111110000010000000011111
10000000000000000100000010000000000000000000000100000010000001
11000001110101011111011110011100000111111110000010000000011111
10000000000000000000000010000000000000000000000000000010000001
10000000000000000100000000000000000000000000000100000000000001
11000001110101011111011110011100000111111110000010000000011111
10000000000000000000000000000000000000000000000100000010000001
11000001110101011111011110011100000111111110000010000000011111
11000001110101011111011110011100000111111110000010000000011111
10000000000000000100000000000000000000000000000100000010000001
11000001110101011111011110011100000111111110000010000000011111
10000000000000000000000000000000000000000000000100000010000001
11000001110101011111011110011100000111111110000010000000011111
10000000000000000000000000000000000000000000000100000010000001
11000001110101011111011110011100000111111110000010000000011111
10000000000000000000000000000001111111111111111111111111111111
100000000000000011010100100011111
110000011101010111110111100111
11110111 1110101 101111010001
11111111 1111111 111111111111

=== ORIENTATION ===
NORTH == textures/N.xpm
SOUTH == textures/S.xpm
WEST == textures/W.xpm
EAST == textures/E.xpm
=== FLOOR && CEILING ===
F = 0,0,0
C = 150,0,50
=== GAME MAP ===
'    1111111111111111111111111                                 '
'    1000000000110000000000001                                 '
'    10110000011100000000010001                                '
'    1001000000000000000000001                                 '
'111111111011000011100000000111111                             '
'100000000011000001110111111000011                             '
'111101111111110111000000100011111                             '
'11110111111111011101010010001                                 '
'11000000110101011100000000001111                              '
'10000000000000N00100000010000001111111111111111111111111111111'
'10000000000000000100000010000000000000000000000100000010000001'
'11000001110101011111011110011100000111111110000010000000011111'
'10000000000000000100000010000000000000000000000100000010000001'
'11000001110101011111011110011100000111111110000010000000011111'
'10000000000000000000000010000000000000000000000000000010000001'
'10000000000000000100000000000000000000000000000100000000000001'
'11000001110101011111011110011100000111111110000010000000011111'
'10000000000000000000000000000000000000000000000100000010000001'
'11000001110101011111011110011100000111111110000010000000011111'
'11000001110101011111011110011100000111111110000010000000011111'
'10000000000000000100000000000000000000000000000100000010000001'
'11000001110101011111011110011100000111111110000010000000011111'
'10000000000000000000000000000000000000000000000100000010000001'
'11000001110101011111011110011100000111111110000010000000011111'
'10000000000000000000000000000000000000000000000100000010000001'
'11000001110101011111011110011100000111111110000010000000011111'
'10000000000000000000000000000001111111111111111111111111111111'
'100000000000000011010100100011111                             '
'110000011101010111110111100111                                '
'11110111 1110101 101111010001                                 '
'11111111 1111111 111111111111                                 '
=== NEW MAP ===
'    1111111111111111111111111                                 '
'    1XXXXXXXXX11XXXXXXXXXXXX1                                 '
'    1X11XXXXX111XXXXXXXXX1XXX1                                '
'    1XX1XXXXXXXXXXXXXXXXXXXX1                                 '
'111111111X11XXXX111XXXXXXXX111111                             '
'1XXXXXXXXX11XXXXX111X111111XXXX11                             '
'1111X111111111X111XXXXXX1XXX11111                             '
'1111X111111111X111X1X1XX1XXX1                                 '
'11XXXXXX11X1X1X111XXXXXXXXXX1111                              '
'1XXXXXXXXXXXXXXXX1XXXXXX1XXXXXX1111111111111111111111111111111'
'1XXXXXXXXXXXXXXXX1XXXXXX1XXXXXXXXXXXXXXXXXXXXXX1XXXXXX1XXXXXX1'
'11XXXXX111X1X1X11111X1111XX111XXXXX11111111XXXXX1XXXXXXXX11111'
'1XXXXXXXXXXXXXXXX1XXXXXX1XXXXXXXXXXXXXXXXXXXXXX1XXXXXX1XXXXXX1'
'11XXXXX111X1X1X11111X1111XX111XXXXX11111111XXXXX1XXXXXXXX11111'
'1XXXXXXXXXXXXXXXXXXXXXXX1XXXXXXXXXXXXXXXXXXXXXXXXXXXXX1XXXXXX1'
'1XXXXXXXXXXXXXXXX1XXXXXXXXXXXXXXXXXXXXXXXXXXXXX1XXXXXXXXXXXXX1'
'11XXXXX111X1X1X11111X1111XX111XXXXX11111111XXXXX1XXXXXXXX11111'
'1XXXXXXXXXXXXXXXXXXXXXXXXXXXXXXXXXXXXXXXXXXXXXX1XXXXXX1XXXXXX1'
'11XXXXX111X1X1X11111X1111XX111XXXXX11111111XXXXX1XXXXXXXX11111'
'11XXXXX111X1X1X11111X1111XX111XXXXX11111111XXXXX1XXXXXXXX11111'
'1XXXXXXXXXXXXXXXX1XXXXXXXXXXXXXXXXXXXXXXXXXXXXX1XXXXXX1XXXXXX1'
'11XXXXX111X1X1X11111X1111XX111XXXXX11111111XXXXX1XXXXXXXX11111'
'1XXXXXXXXXXXXXXXXXXXXXXXXXXXXXXXXXXXXXXXXXXXXXX1XXXXXX1XXXXXX1'
'11XXXXX111X1X1X11111X1111XX111XXXXX11111111XXXXX1XXXXXXXX11111'
'1XXXXXXXXXXXXXXXXXXXXXXXXXXXXXXXXXXXXXXXXXXXXXX1XXXXXX1XXXXXX1'
'11XXXXX111X1X1X11111X1111XX111XXXXX11111111XXXXX1XXXXXXXX11111'
'1XXXXXXXXXXXXXXXXXXXXXXXXXXXXXX1111111111111111111111111111111'
'1XXXXXXXXXXXXXXX11X1X1XX1XXX11111                             '
'11XXXXX111X1X1X11111X1111XX111                                '
'1111X111 111X1X1 10111101XXX1                                 '
'11111111 1111111 111111111111                                 '
==587075== 
==587075== FILE DESCRIPTORS: 4 open (3 std) at exit.
==587075== Open file descriptor 103: /usr/share/code/v8_context_snapshot.bin
==587075==    <inherited from parent>
==587075== 
==587075== 
==587075== HEAP SUMMARY:
==587075==     in use at exit: 0 bytes in 0 blocks
==587075==   total heap usage: 2,834 allocs, 2,834 frees, 1,514,281 bytes allocated
==587075== 
==587075== All heap blocks were freed -- no leaks are possible
==587075== 
==587075== For lists of detected and suppressed errors, rerun with: -s
==587075== ERROR SUMMARY: 0 errors from 0 contexts (suppressed: 2 from 1)
